abrasive - abrasivo
abusive - abusivo
adhesive - adhesivo
aggressive - agresivo
apprehensive - aprensivo
comprehensive - comprensible
compulsive - obsesivo
conclusive - concluyente
cursive - cursiva
decisive - decisivo
defensive - defensiva
effusive - efusivo
elusive - evasivo
evasive - evasivo
excessive - excesivo
exclusive - exclusivoexpensive
(iksp√©ntsiv) -
caro
explosive - explosivo
expressive - expresivo
impressive - impresionante
impulsive - impulsivo
incisive - incisivo
massive - masivo
obsessive - obsesivo
offensive - ofensivo
passive - pasivo
pensive - pensativo
permissive - permisivo
persuasive - persuasivo
possessive - posesivo
progressive - progresivo
regressive - regresivo
repulsive - repulsivo
responsive - sensible
submissive - sumiso
successive - sucesivo