abnormal - anormal
accidental - casual
additional - adicional
adjectival - adjetival
adverbial - adverbial
agricultural - agrícola
amoral - amoral
anal - anal
ancestral - ancestral
annual - anual
antisocial - antisocial
arboreal - arbóreo
architectural - arquitectónico
artificial - artificial
banal - banal
beneficial - beneficioso
bestial - bestial
bilingual - bilingüe
bridal - nupcial
brutal - brutal
capital - capital
cardinal - cardinal
carnal - carnal
casual - informal
celestial - celestial
central - central
cerebral - cerebral
ceremonial - ceremonioso
coastal - costero
collateral - garantía subsidiaria
colloquial - familiar
commercial - comercialconditional - condicional
confidential - confidencial
congenital - congénito
conjugal - conyugal
constitutional - constitucional
continental - continental
continual - continuo
controversial - polémico
conventional - convencional
cordial - cordial
corporeal - corpóreo
criminal - criminal
crucial - crucial
cultural - cultural
dental - dental
differential - diferencial
digital - digital
educational - educativo
electoral - electoral
emotional - sensible
environmental - ambiental
equal - igual
essential - esencial
eternal - eterno
exceptional - excepcional
experimental - experimental
facial - facial
fatal - fatal
final - final
financial - financiero
formal - formal
frugal - frugalfundamental - fundamental
general - general
gradual - gradual
gremial - gremial
heterosexual - heterosexual
homosexual - homosexual
horizontal - horizontal
ideal - ideal
illegal - ilegal
immoral - inmoral
impartial - imparcial
imperial - imperial
impersonal - impersonal
industrial - industrial
informal - informal
initial - inicial
instrumental - instrumental
intellectual - intelectual
intentional - intencional
international - internacional
irrational - irracional
jovial - jovial
judicial - judicial
labial - labial
legal - legal
lethal - letal
literal - literal
local - local
loyal - leal
marital - matrimonial
martial - marcial
memorial - conmemorativomenial - servil
mental - mental
mortal - mortal
mutual - mutuo
nasal - nasal
national - nacional
natural - natural
naval - naval
neutral - neutral
normal - normal
nuptial - nupcial
occasional - ocasional
official - oficial
operational - operacional
optional - opcional
oral - oral
original - original
oval - oval
partial - parcial
perpetual - perpetuo
personal - personal
pictorial - ilustrado
postal - postal
potential - potencial
primordial - primordial
professional - profesional
proportional - proporcional
proverbial - proverbial
racial - racial
rational - racional
real - real
recreational - recreativoregional - regional
residential - residencial
seasonal - estacional
sensational - sensacional
sensual - sensual
sentimental - sentimental
serial - serial
sexual - sexual
social - social
special - especial
spiritual - espiritual
superficial - superficial
supernatural - sobrenatural
terrestrial - terrestre
territorial - territorial
textual - textual
total - total
traditional - tradicional
trivial - trivial
universal - universal
visual - visual
vital - vital