abolished - abolido
absent-minded - distraído
admired - admirado
amazed - asombrado
amused - divertido
annoyed - enojado
ashamed - avergonzado
bad-tempered - malhumorado
bored - aburrido
broad-minded - tolerante
complicated - complicado
conceited - vanidoso
confused - confundido
connected - relacionado
crooked - torcido
crowded - atestado
delighted - encantado
depressed - deprimido
determined - decidido
disappointed - decepcionado
disgusted - asqueado
educated - culto
embarrased - avergonzado
encouraged - animado
enraged - enfurecido
esteemed - estimado
evoked - evocado
excited - emocionado
expected - esperado
frightened - asustado
gifted - talentoso
horrified - horrorizadoimpressed
(imprést) -
impresionado
interested - interesado
involved - complicado
irritated - irritado
naked - desnudo
narrow-minded - intolerante
occupied - ocupado
packed - repleto de gente
pleased - encantado
quick-tempered - irascible
related - relacionado
sacred - sagrado
satisfied - satisfecho
scared - asustado
skilled - hábil
suprised - sorprendido
terrified - aterrado
tired - cansado
united - unido
unprincipled - inescrupuloso
wicked - malvado
worried - preocupado
wounded - herido