accurate - exacto
adequate - adecuado
affectionate - afectuoso
appoximate - aproximado
appropiate - apropiado
articulate - elocuente
compassionate - compasivo
considerate - considerado
degenerate - degenerado
deliberate - deliberado
delicate - delicado
desolate - desconsolado
desperate - desesperado
duplicate - duplicado
effeminate - afeminado
elaborate - detalladofortunate
(fórtchunet) -
afortunado
illegitimate - ilegítimo
immediate - inmediato
immoderate - excesivo
immoderate - desmedido
inaccurate - inexacto
inadequate - inadecuado
inappropiate - inapropiado
indiscriminate - indiscriminado
intimate - íntimo
intricate - intrincado
legitimate - legítimo
literate - alfabetizado
moderate - moderado
obstinate - obstinado
passionate - apasionado