analytical - analítico
anatomical - anatómico
anthropological - antropológico
apolitical - apolítico
astrological - astrológico
astronomical - astronómico
asymmetrical - asimétrico
atypical - atípico
autobiographical - autobiográfico
bacteriological - bacteriológico
biological - biológico
cervical - cervical
chemical - químico
chronological - cronológico
classical - clásico
clerical - administrativo
critical - crítico
cynical - cínico
diabolical - diabólico
ecological - ecológico
economical - económico
electrical - eléctrico
ethical - ético
fanatical - fanático
farcical - ridículo
gastronomical - gastronómico
geographical - geográfico
geological - geológico
geometrical - geométrico
grammatical - gramatical
historical - histórico
hypocritical - hipócritahysterical
(histérikal) -
histérico
identical - idéntico
ideological - ideológico
illogical - ilógico
impractical - poco práctico
ironical - irónico
lackadaisical - indiferente
lexical - léxico
logical - lógico
lyrical - lírico
magical - mágico
mathematical - matemático
mechanical - mecánico
medical - médico
methodical - metódico
musical - musical
mystical - místico
mythical - mítico
nautical - náutico
numerical - numérico
optical - óptico
pathological - patológico
periodical - periódico
physical - físico
polemical - polémico
political - político
practical - práctico
psychological - psicológico
radical - radical
rhetorical - retórico
skeptical - escéptico
statistical - estadísticosurgical
(sédchikal) -
quirúrgico
tactical - táctico
technical - técnico
technological - tecnológico
theatrical - teatral
theological - teológico
topical - actual
tropical - tropical
typical - típico
vertical - vertical
whimsical - caprichoso¿Te sirvió esta información?
¡Compártela!
Mi curso Sherton
Síguenos en
Sherton English - curso de inglés gratis
Tweets
por @shertonenglish
Secciones principales
Inicio
Curso Sherton, Inglés en 52 semanas
Pizarrón del día
Foro
VOCABULARY.
ONE
Herramientas
Contacto
Testimonios
Términos de uso del sitio
Política de privacidad
Mapa del sitio
©1999-2020
Sherton English
Todos los derechos reservados.
Los contenidos de este sitio son originales y no pueden ser reproducidos sin la expresa autorización de los autores. En casos puntuales en los que la información provenga de otra fuente, ésta será expresamente citada.