abundant - abundante
adamant - inflexible
arrogant - arrogante
ascendant - ascendiente
aspirant - aspirante
blatant - ostensible
brilliant - brillante
constant - constante
determinant - determinante
deviant - extravagante
discordant - discordante
discrepant - discrepante
distant - distante
dominant - dominante
elegant - elegante
equidistant - equidistante
exorbitant - desorbitado
expectant - expectante
extravagant - extravagante
exuberant - eufórico
exultant - jubiloso
flagrant - flagrante
flamboyant - extravagante
gallant - galán
giant - gigante
hesitant - dubitativo
ignorant - ignorante
important - importante
inconstant - inconstante
intolerant - intolerante
itinerant - itinerante
jubilant - radiante de alegríapedant
(pédant) -
pedante
pleasant - agradable
punctual - puntual
redundant - redundante
relevant - relevante
reluctant - reacio
repugnant - repugnante
significant - significativo
tolerant - tolerante
unpleasant - desagradable
valiant - valiente