
Lista de algunas palabras inglesas con letra 'W' muda: wrap, wreck, answer, sword, ...hoever - quienquiera
hoever - quienquiera
hole - entero
hom - quien
hore - puta
hose - cuyo
rangle - disputa
rap - abrigo
rath - ira
reath - corona
reck - ruina
rench - llave inglesa
restle - luchar
retch - desgraciado
riggle - meneo
ring - torcer
rinkle - arruga
rist - muñeca
rite - escribir
rithe - retorcerse
ritten - escrito
rong - incorrecto
rote - escribió
rought - trabajado
rung - torcido
(dóon)
- alba
fla - defecto
(lóo)
- ley - césped
(póo)
- pata - vio
stra - paja
ans - respuesta
kno
ledge - conocimiento
yer - abogado
ord - espada
