Lista de algunas palabras inglesas con el sonido 'óu' del español: gold, coat, hole, slow, ...
boat - barco, buque
coal - carbón
coat - abrigo, saco
foal - potro
foam - espuma
goal - meta, objetivo
goat - cabra
hoax -  engañar, broma, trampa
load - cargar, carga
loaf - holgazanear
loan - prestar, préstamo
moan - gemir, quejarse, gemido
moat - foso
cloak - capa, manto
croak - croar, graznar
float - flotar, boyar
groan - gemir, quejarse, gemido, quejido
road - camino, carretera
roam - vagar
soak - remojar, empapar, remojo
soap - jabón
toad - sapo
shoal - banco de arena o de peces
throat - garganta.
low - bajo
mow - cortar, segar
row - fila, línea
sow - sembrar
tow - remolcar
slow - lento
blow - soplar, golpe
crow - cuervo
flow - flujo, fluír
glow - brillar, resplandor
grow - crecer
know - saber, conocer
show - mostrar
snow - nieve, nevar
stow - guardar, meter.
bold - atrevido, valiente
cold - frío, resfrío
bolt - tornillo, bulón
fold - plegar, doblar, pliegue
gold - oro
hold - sostener, agarrar, retener
mold - molde, amoldar
scold - reñir
hole - agujero, orificio
mole - lunar, topo
pole - polo, palo, asta
role - papel
sole - suela, talón, único
whole - completo, entero
stole - pasado de steal
parole - libertad condicional