Lista de algunas palabras inglesas con el sonido 'éer' del español: learn, turn, bird, sir, ...
fir - abeto
sir - señor
bird - pájaro
dirt - suciedad, mugre
firm - empresa, compañia, firma
girl - chica, niña
birch - abedul
birth - nacimiento
first - primero
girth - faja, cinturón
chirp - gorjeo, gorjear
flirt - flirtear
shirt - camisa
skirt - falda, pollera
stir - revolver
swirl - remolino, arremolinarse
urn - urna
fur - piel, pelo
burn - quemar, quemadura
hurt - herir, herida
curb - cordón de vereda, restricción
curl - rizo, rulo
curt - corto, conciso
hurl - lanzar, arrojar
lurk - estar al acecho, esconderse
lurch - sacudida, dar sacudidas
blurt - decir bruscamente
churn - revolver, batir
spur - espuela
spurt - borbotón, salir en chorros
church - iglesia
turn - dar vuelta, vuelta, turno
earn - ganar
earth -  tierra
heard - pasado del verbo hear
learn - aprender
pearl - perla
search - buscar, revisar
yearn - anhelar
word - palabra
work - trabajo
worm - gusano
worth - valor
worse - peor
worst - lo peor
world - mundo