Las palabras homófonas son palabras que tienen diferente ortografía y significado, pero se pronuncian igual.
peak - pico, cumbre, punta
peek - atisbar, mirar a hurtadillas
peal - repique, estruendo
peel - pelar, cáscara
pedal - pedal, pedalear
peddle - vender de puerta en puerta
peer - par, igual, compañero
pier - muelle, desembarcadero
(pái)
-  pi
pie - pastel
pistil - pistilo
pistol - pistola
plain - claro, evidente, sencillo
plane - avión
plumb - sondar, plomada
plum - ciruela
pole - polo, asta, palo, poste, mástil
poll - encuesta, votación
pore - poro
pour - verter, echar
pray - rezar, orar, suplicar
prey - presa
principal - principal, director
principle - principio
prophet - profeta
profit - ganancia, beneficio
rap - dar un golpecito
wrap - envolver, envoltura
read - leer
reed - junco, caña
rein - rienda
- rain -  lluvia
reign - reino, soberanía
ring - anillo, ring
wring - retorcer
road - camino, carretera
rode - pasado de ride
route - ruta
root - raíz
rye - centeno
wry - irónico
sale - venta
sail - navegar
scene - escena
seen - pasado de see
sea - mar
see - ver
seam - costura
seem - parecer
shear - esquilar
sheer - puro, completo
sleigh - trineo
slay - matar
sole - suela
soul - alma
son - hijo
sun - sol
some - algún, algo de
sum - suma, cantidad
sore - herida, llaga, dolorido
soar - remontarse, volar
stake - estaca, apuesta
steak - biftect
stair - escalón
stare - mirada fija,
steal - robar, hurtar
steel - acero
step - paso, pisada
steppe - estepa
strait - estrecho
straight - directo, derecho, recto
suite - cuarto
sweet - dulce
tail - cola, rabo
tale - cuento, chisme, fábula
taught - pasado de teach
taut - tenso, tirante
team - equipo
teem - rebozar
tier - grada, piso
tear - lágrima
there - allí, allá, ahí
their -  su
threw - pasado de throw
through -  através de
throne - trono
thrown - pasado de throw
(tchú)
- a, para
- two -  dos
too - también, demasiado
toe - dedo del pie
tow - remolcar, remolque
vane - aspa, paleta, veleta
vain - vano, presumido
waist - cintura
waste - derrochar, basura, pérdida
wait - esperar, servir
weight - peso
war - guerra
wore - pasado de wear
way - manera, modo, dirección, sentido
weigh - pesar
weak - débil
week - semana
wholly - completamente
holy - santo, sagrado
would
(wúud)
wood - madera, bosque
write - escribir
right - derecho, apropiado, justo
yoke - yugo
yolk - yema¿Te sirvió esta información?
¡Compártela!
Mi curso Sherton
Síguenos en
Sherton English - curso de inglés gratis
Tweets
por @shertonenglish
Secciones principales
Inicio
Curso Sherton, Inglés en 52 semanas
Pizarrón del día
Foro
VOCABULARY.
ONE
Herramientas
Contacto
Testimonios
Términos de uso del sitio
Política de privacidad
Mapa del sitio
©1999-2020
Sherton English
Todos los derechos reservados.
Los contenidos de este sitio son originales y no pueden ser reproducidos sin la expresa autorización de los autores. En casos puntuales en los que la información provenga de otra fuente, ésta será expresamente citada.