Las palabras homófonas son palabras que tienen diferente ortografía y significado, pero se pronuncian igual.
fowl - ave de corral
foul - asqueroso, falta
gait - modo de andar
gate - puerta
gorilla - gorila
guerrilla - guerrillero/a
great - grande, gran
grate - reja, verja, parrilla, rallar
hair - pelo, cabello, cabellera
hare - liebre
hall - vestíbulo, salón
haul - transportar, arrastrar, tirón
halve - partir en dos
have - tener, haber
hanger - percha
hangar - hangar
here - aquí, acá
hear - oír, escuchar
herd - manada, rebaño
heard - pasado de hear
heal - curar , sanar
heel - talón, tacón
heroin - heroína - la droga -
heroine - heroína - la protagonista -
him
(jím)
hymn - himno
hoard - depósito, tesoro, acumular
horde - horda
hole - agujero, hueco, hoyo
whole - entero, total, completo
hostel - albergue juvenil
hostile - hostil
hour - hora
our - nuestro/a nuestros/as
idle - ocioso, perder el tiempo
idol - ídolo
isle - ísla
I'll
(áil)
key - llave, clave, tecla
quay - muelle, desembarcadero
knead - amasar
need - necesitar
knot - nudo, lazo, anudar, enlazar
not
(nót)
lain - pasado de lie
lane - carril, senda
leak - gotera, filtración, gotear
leek - puerro
lessen - disminuir, reducir
lesson - lección, enseñanza
load - carga, cargar
lode - veta - en una mina -
loan - prestar, préstamo
lone - solo, solitario
loot - botín, saqueo
lute - laúd
made - pasado de make
maid - empleada doméstica
male - masculino, macho
mail - correspondencia
mane - melena, crín
main - principal, primero
meat - carne
meet - encontrarse con
medal - medalla
meddle - entrometerse
might - poder, fuerza
mite - ácaro
moan - gemido, quejarse, gemir
mown - cortar, segar
morning - mañana
mourning - luto, duelo
mussel - mejillón
muscle - músculo
naval - naval
navel - ombligo
nay -  no
neigh - relinchar, relincho
night - noche
knight - caballero
know - saber, conocer
(nóu)
-  no
none - niguno, nada
nun - monja
one - uno/a
won - pasado de win
(óor)
-  o
- oar
remo
ore - mineral
(óu)
owe - deber, adeudar
pail - cubo, balde
pale - pálido
pain - dolor, aflicción, pena
pane - vidrio, hoja de vidrio
pair - par
- pare -  cortar, recortar
pear - pera
palette - paleta
palate - paladar
peace - paz
piece - pedazo, trozo¿Te sirvió esta información?
¡Compártela!
Mi curso Sherton
Síguenos en
Sherton English - curso de inglés gratis
Tweets
por @shertonenglish
Secciones principales
Inicio
Curso Sherton, Inglés en 52 semanas
Pizarrón del día
Foro
VOCABULARY.
ONE
Herramientas
Contacto
Testimonios
Términos de uso del sitio
Política de privacidad
Mapa del sitio
©1999-2022
Sherton English
Todos los derechos reservados.
Los contenidos de este sitio son originales y no pueden ser reproducidos sin la expresa autorización de los autores. En casos puntuales en los que la información provenga de otra fuente, ésta será expresamente citada.