Lista de algunas palabras inglesas con el sonido 'áu' del español: round, out, down, now, ...
douse - mojar, apagar
rouse - despertar
house - casa
blouse - blusa
grouse - queja, quejarse
spouse - esposo/a , consorte
mouse - ratón, laucha
louse - piojo
out - afuera
bout - combate, ataque
doubt - duda
hour - hora
pout - poner mala cara, hacer pucheros
about - acerca de, sobre, aproximadamente
clout - golpe, bofetada
flout - burlarse
scout - explorador, explorar
shout - grito, gritar
snout - hocico, jeta
spout - pico de jarra
stout - corpulento, robusto
trout - trucha
gout - gota
foul - falta, repugnante
loud - en voz alta, ruidoso
lout - patán
noun - sustantivo
rout - derrota
sour - agrio, ácido
bound - límite, limitar
round - redondo
sound - sano, seguro, sonido
count - contar, cuenta
found - fundar , pasado del verbo find
pound - libra, golpear
hound - acosar, perro de caza
mound - montón de tierra , montículo
ground - tierra, suelo
mount - montar, montaña
amount - cantidad, suma, importe
crouch - agacharse, acurrucarse
pouch - bolsa, saco
mouth - boca
cow - vaca
how - cómo
now - ahora
vow - voto, deseo, prometer
brow - frente, ceja
plow - arado, arar
prow - proa
brown - marrón
clown - payaso
growl - gruñir
crowd - multitud, gentío
crown - corona
drown - ahogarse, ahogar
frown - fruncir el ceño