actor - actor
advisor - consejero
aggressor - agresor
ambassador - embajador
ancestor - antepasado
anchor - ancla
armor - armadura
auditor - auditor
author - autor
bachelor - soltero
behavior - comportamiento
benefactor - benefactor
calculator - calculadora
candor - franqueza
censor - censor
chancellor - canciller
collector - coleccionista
color - color
commentator - comentarista
competitor - competidor
conqueror - conquistador
contractor - contratista
contributor - contribuyente
corridor - pasillo
counselor - consejero
creator - creador
creditor - acreedor
curator - conservador
debtor - deudor
decorator - decorador
demonstrator - manifestante
detector - detector
dictator - dictador
director - director
doctor - doctor
donor - donante
editor - editor
elevator - ascensor
emperor - emperador
endeavor - esfuerzo
error - error
escalator - escalera mecánica
executor - ejecutor
exterior - exterior
factor - factor
favor - favor
flavor - sabor
gladiator - gladiador
governor - gobernador
harbor - puerto
honor - honor
horror - horror
humor - humor
incinerator - incinerador
incubator - incubadora
indicator - indicador
inspector - inspector
instructor - instructor
interior - interior
investigator - investigador
janitor - portero
labor - trabajo
major - comandante
mayor - alcalde
metaphor - metáfora
minor - menor
mirror - espejo
monitor - monitor
navigator - navegante
neighbor - vecino
operator - operador
predecessor - precursor
professor - profesor
proprietor - propietario
radiator - radiador
rancor - rencor
reactor - reactor
refrigerator - refrigerador
rumor - rumor
sailor - marinero
sculptor - escultor
senator - senador
spectator - espectador
splendor - esplendor
sponsor - patrocinador
suitor - pretendiente
tailor - sastre
terror - terror
traitor - traidor
tremor - temblor
vendor - vendedor
vigor - vigor
visitor - invitado
warrior - guerrero