admiral - almirante
appraisal - evaluación / tasación
approval - aprobación
arousal - excitación sexual
arrival - llegada
arsenal - arsenal
betrayal - traición
burial - entierro
canal - canal
cannibal - caníbal
capital - capital
carnival - carnaval
caudal - caudal
cereal - cereal
chemical - sustancia química
coal - carbón
coral - coral
credential - credencial
criminal - criminal
cristal - cristal
deal - trato
denial - negación
diagonal - diagonal
disapproval - desaprovación
dismissal - despido, destitución
disposal - eliminación / disponibilidad
editorial - editorial
festival - festival
funeral - funeral, entierro
ideal - ideal
interval - intervalo
medal - medalla
mammal - mamífero
manual - manual
mural - mural
pedal - pedal
proposal - propuesta
refusal - rechazo
rehearsal - ensayo
removal - eliminación, extirpación
renewal - renovación
retrieval - recuperación
ritual - ritual
rival - rival
sandal - sandalia
scandal - escándalo
signal - señal
spiral - espiral
survival - supervivencia
trial - proceso judicial / ensayo
vandal - vándalo