abnormality - anormalidad
acidity - acidez
activity - actividad
adversity - adversidad
affinity - afinidad
agility - agilidad
ambiguity - ambigüedad
anonymity - anonimato
antiquity - antigüedad
atrocity - atrocidad
audacity - audacia
austerity - austeridad
authority - autoridades
bestiality - bestialidad
brevity - brevedad
brutality - brutalidad
calamity - calamidad
capacity - capacidad
captivity - cautiverio
cavity - cavidad
celerity - celeridad
charity - caridad
chastity - castidad
clarity - claridad
commodity - mercadería
community - comunidad
complexity - complejidad
confidentiality - confidencialidad
conformity - conformidad
continuity - continuidad
cordiality - cordialidad
creativity - creatividad
curiosity - curiosidad
density - densidad
dexterity - destreza
dignity - dignidad
disparity - disparidad
diversity - diversidad
divinity - divinidad
duality - dualidad
electricity - electricidad
enmity - enemistad
equality - igualdad
equanimity - ecuanimidad
eternity - eternidad
eventuality - eventualidad
familiarity - familiaridad
fatality - fatalidad
festivity - festividad
fidelity - fidelidad
flexibility - flexibilidad
fraternity - fraternidad
futility - inutilidad
generosity - generosidad
geniality - afabilidad
gravity - gravedad
hospitality - hospitalidad
humanity - humanidad
humidity - humedad
humility - humildad
identity - identidad
immensity - inmensidad
immortality - inmortalidad
ingenuity - ingenio
liability - responsabilidad
longevity - longevidad
majority - mayoría
maternity - maternidad
maturity - madurez
mentality - mentalidad
minority - minoría
modernity - modernidad
mortality - mortalidad
nationality - nacionalidad
neutrality - neutralidad
nudity - desnudez
obesity - obesidad
oddity - singularidad
opacity - opacidad
originality - originalidad
personality - personalidad
popularity - popularidad
productivity - productividad
propensity - propensión
prosperity - prosperidad
purity - pureza
quality - calidad
quantity - cantidad
rarity - rareza
reality - realidad
regularity - regularidad
sanity - cordura
security - seguridad
similarity - semejanzas
solidarity - solidaridad
unity - unidad
utility - utilidad
vanity - vanidad
vitality - vitalidad