adulterer - adúltero
adviser - consejero
announcer - anunciador
astrologer - astrólogo
astronomer - astrónomo
baker - panadero
babysitter - niñera
breadwinner - cabeza de familia
butcher - carnicero
carpenter - carpintero
cashier - cajero
dancer - bailarín
driver - conductor
employer - patrón
engineer - ingeniero
explorer - explorador
farmer - agricultor
firefighter - bombero
hairdresser - peluquero
fishmonger - pescadero
matchmaker - casamentero
miner - minero
painter - pintor
photographer - fotógrafo
plumber - plomero
porter - portero
reader - lector
reporter - periodista
slavedriver - negrero
waiter - camarero/mozo
worker - trabajador
writer - escritor