accomplishment - logro
achievement - logro
acknowledgement - reconocimiento
adjustment - ajuste
advancement - progreso
advertisement - anuncio
agreement - acuerdo
ailment - dolencia
amazement - asombro
amendment - enmienda
amusement - divesión
announcement - anuncio
annulment - anulación
apartment - apartamento
appointment - cita
argument - argumento
armament - armamento
arrangement - arreglo
assessment - evaluación
assignment - asignación
assortment - surtido
astonishment - asombro
basement - sótano
bewilderment - desconcierto
comment - comentario
commitment - compromiso
compartment - compartimento
complement - complemento
compliment - elogio
confinement - reclusión
department - departamento
derailment - descarrilamiento
detachment - separación
detriment - perjuicio
development - desarrollo
disagreement - desacuerdo
disappointment - desilusión
document - documento
element - elemento
embarrassment - vergüenza
employment - empleo
enactment - promulgación
enchantment - encanto
encouragement - estímulo
endorsement - endoso
engagement - compromiso
enjoyment - placer
entertainment - entretenimiento
environment - ambiente
equipment - equipo
establishment - establecimiento
excitement - entusiasmo
experiment - experimento
fragment - fragmento
fulfillment - cumplimiento
impediment - impedimiento
impoverishment - empobrecimiento
imprisonment - encarcelamiento
improvement - mejora
increment - incremento
instrument - instrumento
investment - inversión
judgement - juicio
measurement - medida
moment - momento
movement - movimiento
nourishment - alimento
ointment - ungüento
ornament - ornamento
parliament - parlamento
pavement - pavimento
payment - pago
pigment - pigmento
punishment - castigo
refreshment - refresco
regiment - regimiento
reinforcement - refuerzo
replacement - reemplazo
requirement - exigencia
resentment - resentimiento
retirement - retiro
sacrament - sacramento
sediment - sedimento
segment - segmento
sentiment - sentimiento
settlement - establecimiento
shipment - envío
statement - declaración
supplement - suplemento
torment - tormento
tournament - torneo
treatment - tratamiento
unemployment - desempleo