activist - activista
alchemist - alquimista
altruist - altruista
anarchist - anarquista
annalist - analista
archeologist - arqueólogo
artist - artista
atheist - ateo
biologist - biólogo
buddhist - budista
capitalist - capitalista
cartoonist - dibujante
chemist - químico
communist - comunista
cyclist - ciclista
dentist - dentista
dramatist - dramaturgo
druggist - farmacéutico
ecologist - ecologista
economist - economista
evangelist - evangelista
exhibitionist - exhibicionista
existentialist - existencialista
exorcist - exorcista
extremist - extremista
fascist - fascista
feminist - feminista
florist - florista
gynecologist - ginecólogo
hairstylist - peluquero
humorist - humorista
idealist - idealista
illusionist - ilusionista
industrialist - industrial
journalist - periodista
linguist - lingüista
masochist - masoquista
meteorologist - meteorólogo
motorcyclist - motociclista
motorist - automovilista
nationalist - nacionalista
naturalist - naturalista
novelist - novelista
nudist - nudista
ophthalmologist - oftalmólogo
opportunist - oportunista
optimist - optimista
pacifist - pacifista
palaeontologist - paleontólogo
pessimist - pesimista
pharmacist - farmacéutico
physicist - físico
pianist - pianista
protagonist - protagonista
psychiatrist - psiquiatra
psychologist - psicólogo
rapist - violador
realist - realista
receptionist - recepcionista
scientist - científico
socialist - socialista
sociologist - sociólogo
soloist - solista
specialist - especialista
terrorist - terrorista
tourist - turista
ventriloquist - ventrílocuo
violinist - violinista