awaken - despertar
blacken - ennegrecer
broaden - ensanchar
burden - cargar
cheapen - abaratar
coarsen - embrutecer
darken - oscurecer
deaden - reducir/aliviar
deafen - ensordecer
deepen - profundizar
enlighten - aclarar
fasten - sujetar
fatten - engordar
freshen - refrescar
frighten - asustar
gladden - alegrar
glisten - relucir
happen - suceder
harden - endurecer
hasten - apresurar
hearten - animar
lengthen - alargar
lighten - aclarar
listen - escuchar
madden - enfurecer
moisten - humedecer
open - abrir
quicken - acelerar
quieten - tranquilizar
redden - enrojecer
sadden - entristecer
sharpen - afilar
shorten - acortar
sicken - enfermarse
soften - ablandar
steepen - aumentar
stiffen - poner rÃ­gido
straighten - enderezar
strengthen - reforzar
sweeten - endulzar