amplify - amplificar
beatify - beatificar
beautify - embellecer
certify - certificar
clarify - clarificar
classify - clasificar
codify - codificar
complexify - complicar
crucify - crucificar
deify - deificar
dignify - dignificar
disqualify - descalificar
diversify - diversificar
edify - edificar
exemplify - ejemplificar
fortify - fortificar
glorify - glorificar
gratify - satisfacer
horrify - horrorizar
humidify - humedecer
identify - identificar
indemnify - indemnizar
intensify - intensificar
justify - justificar
magnify - ampliar
modify - modificar
mortify - mortificar
mystify - desconcertar
notify - notificar
nullify - anular
pacify - pacificar
personify - personificar
petrify - petrificar
purify - purificar
qualify - licenciar
quantify - cuantificar
rectify - rectificar
reunify - reunificar
revivify - avivar de nuevo
signify - significar
simplify - simplificar
solidify - solidificar
specify - especificar
terrify - aterrorizar
testify - declarar
typify - tipificar
unify - unificar
verify - verificar