earn - ganar
ease - aliviar/facilitar
eavesdrop - escuchar a escondidas
echo - hacer eco, repetir
edge - bordear
educate - educar
effect - lograr
eject - expulsar
elaborate - idear, elaborar
elbow - dar codazos
elect - elegir
elevate - elevar
eliminate - eliminar
elucidate - dilucidar
elude - eludir
emanate - emanar
emancipate - emancipar
embarrass - avergonzar
embellish - embellecer
emboss - repujar
embrace - abrazar
embroider - bordar
emerge - emerger, surgir
empathize - identificarse con alguien
emphasize - enfatizar
employ - contratar
empower - conferir poder, autorizar
empty - vaciar
emulate - emular
encase - encerrar, revestir
encircle - rodear, cercar
enclose - encerrar/adjuntar
encompass - rodear/abarcar
encounter
(ink치unter)
encontrar
encourage - alentar
end - finalizar
endorse - endosar
endure - resistir
energize - vigorizar
enfold - envolver
enforce - imponer, hacer cumplir
engage - atraer/comprometer/participar
engrave - grabar
engulf - envolver
enhance - mejorar
enjoy - disfrutar
enlighten - iluminar, aclarar
enquire - pedir informaci칩n
enshroud - cubrir
ensnare - atrapar
entangle - enredar
enter - ingresar
entertain - entretener
enthuse - entusiasmar(se
entice - tentar
entreat - suplicar
entwine - entrlazar
enumerate - enumerar
enunciate - articular
envelop - envolver
envision - imaginar
envy - envidiar
equate - comparar
equivocate - andarse con evasivas
erase - borrar
escape - escapar
escort - escoltar, acompa침ar
establish - establecer
estimate - estimar
etch - grabar al aguafuerte
evacuate - evacuar
evaluate - evaluar
evade - evadir
evaporate - evaporar
evoke - evocar
exacerbate - exacerbar
exaggerate - exagerar
examine - examinar
exasperate - exasperar
excavate - excavar
exchange - intercambiar
excite - entusiasmar
exclaim - exclamar
exclude - excluir
exculpate - exculpar
excuse - disculpar
exercise - hacer ejercicio
exhale - exhalar
exhibit - exhibir
exhort - exhortar
exist - existir
expand - expandir
expatriate - expatriar
expect - esperar
experience - experimentar
explain - explicar
explode - explotar
exploit - explotar, aprovecharse
expose - exponer
expound
(exp치und)
hacer comentarios detallados
express - expresar
expropriate - expropiar
explore - explorar
extend - extender
extinguish - extinguir, apagar
extract - extraer
extrapolate - extrapolar
extricate - librar, sacar
exult - exultar
eye - mirar
eyeball - mirar de arriba a abajo