acclimatize - aclimatar
agonize - atormentar
alphabetize - alfabetizar
anesthetize - anestesiar
analize - analizar
antagonize - fastidiar
apologize - pedir perdón
authorize - autorizar
baptize - bautizar
catechize - catequizar
capitalize - capitalizar
carbonize - carbonizar
cauterize - cauterizar
centralize - centralizar
characterize - caracterizar
civilize - civilizar
colonize - colonizar
commercialize - comercializar
conceptualize - conceptuar
criticize - criticar
demoralize - desmoralizar
deodorize - desodorizar
deoxidize - desoxidar
dramatize - dramatizar
economize - economizar
emphasize - enfatizar
exercise - ejercitar
familiarize - familiarizar
empathize - sentir empatía
evangelize - evangelizar
exorcize - exorcizar
fantasize - fantasear
fertilize - fertilizar
finalize - finalizar
fraternize - confraternizar
harmonize - armonizar
humanize - humanizar
hypnotize - hipnotizar
idealize - idealizar
idolize - idolatrar
immobilize - inmovilizar
immortalize - inmortalizar
immunize - inmunizar
itemize - hacer una lista
jeopardize - poner en peligro
industrialize - industrializar
initialize - inicializar
legalize - legalizar
legitimize - legitimar
liberalize - liberalizar
localize - localizar
maximize - maximizar
memorize - memorizar
mesmerize - hipnotizar
minimize - minimizar
mobilize - movilizar
modernize - modernizar
monopolize - monopolizar
naturalize - naturalizar
neutralize - neutralizar
organize - organizar
pasteurize - pasteurizar
penalize - castigar
popularize - popularizar
publicize - hacer público
personalize - personalizar
rationalize - racionalizar
realize - realizar
recognize - reconocer
reorganize - reorganizar
satirize - satirizar
scandalize - escandalizar
specialize - especializar
stabilize - estabilizar
sterilize - esterilizar
symbolize - simbolizar
theorize - teorizar
visualize - visualizar
terrorize - aterrorizar
tranquilize - tranquilizar
solemnize - solemnizar
standardize - normalizar
subsidize - subvencionar
scrutinize - escudriñar
socialize - relacionar
utilize - utilizar
victimize - victimizar
sympathize - compadecer