affect - afectar
direct - dirigir
collect - reunir
connect - unir
correct - corregir
deflect - desviar
detect - descubrir
direct - directo
disconnect - desconectar
disinfect - desinfectar
disrespect - desacato
dissect - disecar
effect - lograr
eject - expulsar
elect - elegir
erect - erguir
expect - esperar
infect - infectar
inject - inyectar
inspect - inspeccionar
interject - interponer
intersect - cruzar
misdirect - dirigir mal
neglect - abandono
object - oponerse
overprotect - sobreproteger
preselect - preseleccionar
project - proyectar
protect - proteger
recollect - recordar
redirect - desviar
reelect - reelegir
reflect - reflexionar
reject - rechazar/rehusar
respect - respetar
resurrect - resucitar
select - seleccionar
suspect - sospechar