abolish - abolir
accomplish - llevar a cabo
admonish - reprender
astonish - sorprender
banish - desterrar
burnish - pulir
cherish - apreciar
demolish - demoler
diminish - disminuir
distinguish - distinguir
embellish - embellecer
establish - establecer
extinguish - extinguir
finish - terminar
furnish - amueblar
garnish - aderezar
lavish - pr√≥digo
languish - languidecer
nourish - alimentar
perish - fallecer
polish - pulir
publish - publicar
punish - castigar
ravish - violar
relinquish - abandonar
replenish - rellenar
squish - aplastar
vanish - desaparecer
varnish - barnizar
wish - desear