obey - obedecer
object - objetar
oblige - obligar/complacer
observe - observar
obsess - obsesionar
obstruct - atascar
obtain - obtener
obtrude - entrometer
occupy - ocupar
occur - ocurrir
offend - ofender
offer - ofrecer
ogle - quedarse mirando
ooze - rezumar
open - abrir
operate - manejar
oppose - oponerse
opt - optar
orbit - girar, estar en órbita
ordain - decretar
order - ordenar, pedir
organize - organizar
orient - orientar
orientate - encaminar, orientar
originate - producir, crear
ornament - ornamentar
outline - diseñar, delinear
outlive - sobrevivir
outperform - superar a
outwit - ser más listo que
overbalance - perder el equilibrio
overcompensate - sobrecompensar
overflow - inundar
overlook - tener vista a/pasar por alto
overpower - vencer
overturn - dar un vuelco/anular
owe - adeudar, deber
own - poseer