Las partes de la casa en inglés
antenna - antena
attic - desván
back yard - patio trasero
balcony - balcón
basement - sótano
bathroom - baño
bedroom - dormitorio
ceiling - cielorraso
cellar - sótano, bodega
chimney - chimenea
deck - balcón terraza
dining room - comedor
door - puerta
door handle - picaporte
doorbell - timbre
driveway - entrada par el auto
fence - cerca
fence gate - puerta de la cerca
floor - piso
front yard - patio frontal
garage - garage
garden - jardín
garden shed - cobertizo
ground floor - planta baja
hall - vestíbulo
hallway - pasillo
hedge - seto
key - llave
kitchen - cocina
laundry room - lavadero
lawn - césped
living room - sala
lock - cerradura
mailbox - buzón
pantry - despensa
patio - patio
peephole - mirilla de la puerta
pool - piscina
porch - pórtico
roof - techo
room - habitación
skylight - tragaluz, claraboya
staircase - escalera
steps - escalones
study - despacho, estudio
utility room - cuarto de servicio
veranda - galería, veranda
wall - pared
window - ventana
Visita nuestro canal de videos en
YouTube