Vocabulario en inglés sobre el calendario y los períodos de tiempo
afternoon - la tarde
April - abril
August - agosto
century - siglo
day - día
decade - década
December - diciembre
early morning - madrugada
era - era, época
eternity - eternidad
evening - noche
fall / autumn - otoño
February - febrero
Friday - viernes
hour - hora
January - enero
July - julio
June - junio
March - marzo
May - mayo
midnight - medianoche
millennium - milenio
minute - minuto
Monday - lunes
month - mes
morning - mañana
night - noche
noon - mediodía
November - noviembre
October - octubre
Saturday - sábado
second - segundo
September - septiembre
summer - verano
Sunday - domingo
sunrise - amanecer
sunset - atardecer
Thursday - jueves
Tuesday - martes
Wednesday - miércoles
week - semana
winter - invierno
year - año