Vocabulario en inglés sobre la personalidad (rasgos negativos)
absent-minded - distraído
aggressive - agresivo
annoying - molesto
arrogant - arrogante, prepotente
arrogant - arrogante
bad-tempered - malhumorado
boastful - fanfarrón
boring - aburrido
bossy - mandón
cheeky - atrevido
clumsy - torpe
competitive - competitivo
conceited - vanidoso
cowardly - cobarde
credulous - crédulo
cruel - cruel
dishonest - deshonesto
disrespectful - irrespetuoso
dominant - dominante
eccentric - excéntrico
envious - envidioso
fiend - desalmado
forgetful - olvidadizo
frivolous - frívolo
fussy - quisquilloso, exigente
gullible - crédulo
hypocritical - hipócrita
impatient - impaciente
impulsive - impulsivo
indifferent - indiferente
insecure - inseguro
insensitive - insensible
insolent - insolente
introverted - introvertido
irascible - irascible
irresponsible - irresponsable
jealous - celoso
lazy - haragán
lonely - solitario
materialistic - materialista
mean - mezquino, malo
moody - malhumorado
naive - ingenuo
nosy - metido, fisgón
obsessive - obsesivo
obstinate - obstinado, testarudo
passive - pasivo
pessimistic - pesimista
petty - mezquino
pretentious - presuntuoso, pretencioso
proud - orgulloso
rash - imprudente, precipitado
rebellious - rebelde
restless - inquieto
rude - descortés, grosero
ruthless - despiadado
selfish - egoísta
shy - tímido
spiteful - rencoroso
stingy - tacaño
strict - estricto
stubborn - terco
sullen - hosco
talkative - charlatán
unpredictable - impredecible
unreliable - desconfiable
vain - presumido
vicious - despiadado, cruel
vindictive - vengativo