Vocabulario en inglés sobre los países
Afghanistan - Afganistán
Argentina - Argentina
Australia - Australia
Austria - Austria
Belgium - Bélgica
Bolivia - Bolivia
Brazil - Brasil
Bulgaria - Bulgaria
Canada - Canadá
Chile - Chile
China - China
Colombia - Colombia
Costa Rica - Costa Rica
Cuba - Cuba
Czech Republic - República Checa
Denmark - Dinamarca
Dominican Republic - República dominicana
Ecuador - Ecuador
Egypt - Egipto
Englan - Englan
Finland - Finlandia
France - Francia
Germany - Alemania
Greece - Grecia
Greenland - Groenlandia
Guatemala - Guatemala
Haiti - Haití
Hawaii - Hawai
Honduras - Honduras
Hungary - Hungría
Iceland - Islandia
India - India
Indonesia - Indonesia
Iran - Irán
Iraq - Iraq
Ireland - Irlanda
Israel - Israel
Italy - Italia
Jamaica - Jamaica
Japan - Japón
Korea - Corea
Lebanon - Líbano
Malaysia - Malasia
Malta - Malta
Mexico - México
Morocco - Marruecos
Nepal - Nepal
Netherlands - Países Bajos
New Zealand - Nueva Zelanda
Nicaragua - Nicaragua
Nigeria - Nigeria
Norway - Noruega
Pakistan - Paquistán
Palestine - Palestina
Panama - Panamá
Paraguay - Paraguay
Peru - Perú
Philipines - Philipines
Poland - Polonia
Portugal - Portugal
Puerto Rico - Puerto Rico
Rumania - Rumania
Russia - Rusia
Saudi Arabia - Arabia Saudí
Scotland - Escocia
Singapore - Singapur
Spain - España
Sweden - Suecia
Switzerland - Suiza
Syria - Siria
Tahiti - Tahití
Thailand - Tailandia
Tunisia - Túnez
Turkey - Turquía
Ukraine - Ucrania
United Kingdom - Reino Unido
United States - Estados Unidos
Uruguay - Uruguay
Venezuela - Venezuela
Vietnam - Vietnam
Wales - País de Gales
Yugoslavia - Yugoslavia