Vocabulario en inglés sobre insectos y reptiles
alligator - caimán
ant - hormiga
bedbug - chinche
bee - abeja
beetle - escarabajo
butterfly - mariposa
caterpillar - oruga
centipede - ciempiés
chameleon - camaleón
cicada - cigarra
cricket - grillo
crocodile - cocodrilo
dragonfly - libélula
earthworm - lombriz
eel - anguila
firefly - luciérnaga
flea - pulga
fly - mosca
frog - rana
grasshopper - saltamontes
horsefly - tábano
iguana - iguana
ladybird - mariquita
ladybug - mariquita
leech - sanguijuela
lice - piojos
lizard - lagartija
locust - langosta
louse - piojo
mantis - mantis
mosquito - mosquito
moth - polilla
rattlesnake - vívora de cascabel
roach - cucaracha
salamander - salamandra
scorpion - escorpión
snake - vívora
spider - araña
tarantula - tarántula
termite - termita
tick - garrapata
toad - sapo
tortoise - tortuga de tierra
turtle - tortuga
viper - vívora
wasp - avispa
worm - lombriz
worm - gusano
Visita nuestro canal de videos en
YouTube