Vocabulario en inglés sobre delitos y justicia
accesory - cómplice
acquittal - absolución
alibi - coartada
appeal - apelación
arson - incendio premeditado
arsonist - incendiario
assailant - agresor
assassin - asesino (de un político)
assassination - asesinato (de un político)
assault - agresión
attorney - abogado
bail - fianza
blackmail - chantaje
blackmailer - chantajista
briber - sobornador
bribery - soborno
burglar - ladrón (de casas)
burglary - hurto (de casas)
convict - presidiario
court - corte
court case - pleito
court order - orden judicial
crime - delito
custody - custodia
death penalty - pena de muerte
defendant - acusado
drug dealer - vendedor de drogas
evidence - evidencia
felony - crimen
fine - multa
forger - falsificador
forgery - falsificación
fraud - fraude
guilty - culpable, inocente
heir - heredero
hijacking - secuestro de avión
hostage - rehén
indictment - acusación
innocent - inocente
jail - cárcel
judge - juez
jury - jurado
kidnapper - secuestrador
kidnapping - secuestro
lawyer - abogado
life sentence - cadena perpetua
misdemeanor - delito menor
mugger - atracador
mugging - atraco
murder - asesinato
murderer - asesino
narco-trafficker - narcotraficante
narco-trafficking - narcotráfico
not guilty - no culpable
oath - juramento
on parole - en libertad condicional
on probation - en libertad condicional
pickpocket - carterista
pimp - proxeneta
prison - prisión
proof - prueba
prostitute - prostituta
prostitution - prostitución
punishment - castigo
ransom - dinero de rescate
rape - violación sexual
rapist - violador
robber - ladrón
robbery - hurto
shoplifter - ladrón de tiendas
shoplifting - hurto en tiendas
smuggler - contrabandista
smuggling - contrabando
statement - declaración
Supreme Court - Suprema Corte
suspect - sospechoso
swindle - estafa
swindler - estafador
terrorism - terrorismo
terrorist - terrorista
testimony - testimonio
theft - robo
thief - ladrón
threat - amenaza
to abduct - raptar, secuestrar
to accuse - acusar
to acquit - absolver
to arrest - arrestar
to assassinate - asesinar (a un político)
to assault - agredir
to be tried - ser juzgado
to beat up - dar una paliza
to blackmail - chantajear
to bribe - sobornar
to burgle - hurtar
to convict - declarar culpable
to defend - defender
to drug - drogar
to fine - multar
to forge - falsificar
to imprison - encarcelar
to interrogate - interrogar
to kidnap - secuestrar
to kill - matar
to lock up - encerrar
to mug - atracar
to murder - asesinar
to plead guilty - confesarse culpable
to poison - envenenar
to prosecute - procesar, enjuiciar
to rape - violar
to release - poner en libertad
to rob - robar
to search - registrar
to sentence - sentenciar
to serve a sentence - cumplir una condena
to set fire - incendiar
to shoot - disparar
to shoplift - hurtar en tiendas
to smuggle - contrabandear
to spy - espiar
to stab - apuñalar
to steal - robar
to strangle - estrangular
to surround - rodear
to swindle - estafar
to threaten - amenazar
to vandalize - destrozar propiedad
to violate - violar
trial - juicio
vandal - vándalo
vandalism - vandalismo
verdict - veredicto
violation - violación
violator - violador
witness - testigo