Vocabulario en inglés sobre medicinas y remedios
alcohol - alcohol
analgesic - analgésico
antacid tablets - pastillas antiácidas
anti-inflammatory - antiinflamatorio
anti-itch cream - crema contra la picazón
antibiotic - antibiótico
antiseptic - antiséptico
Band-Aid - Curita
bandage - venda
barbiturate - barbitúrico
bottle of aspirin - frasco de aspirinas
calcium - calsio
cold tablets - comprimidos para el resfrío
compound - compuesto
cotton wool - algodón
cough drops - comprimidos para la tos
disinfectant - desinfectante
dose - dósis
drugstore - farmacia
eye drops - gotas para los ojos
first-aid box - caja de primeros auxilios
gauze - gasa
hormone - hormona
injection - inyección
insulin - insulina
iodine - yodo
lab - laboratorio
laxative - laxante
medicine - medicamento
needle - aguja
ointment - pomada
painkiller - calmante para el dolor
peroxide - agua oxigenada
prescription - receta
remedy - remedio
sedative - sedante, calmante
skin cream - crema para la piel
sleeping pills - pastillas para dormir
sunburn cream - crema para quemaduras de sol
suppository - supositorio
syringe - jeringa
syrup - jarabe
thermometer - termómetro
throat spray - spray para la garganta
tissues - pañuelos de papel
toothbrush - cepillo de dientes
tube of ointment - tubo de pomada
vitamin C - vitamina C