Vocabulario en inglés sobre el universo y el cosmos
alien - extraterrestre
asteroid - asteroide
atmosphere - atmósfera
cosmos - cosmos
east - este
eclipse - eclipse
galaxy - galaxia
globe - globo, esfera
gravity - gravedad
Jupiter - Júpiter
light year - año luz
Mars - Marte
Mercury - Mercurio
meteor - meteoro
meteorite - meteorito
morning star - lucero del alba
Neptune - Neptuno
north - norte
orbit - órbita
outer space - espacio exterior
planet - planeta
Satellite - satélite
Saturn - Saturno
shooting star - estrella fugaz
solar system - sistema solar
south - sur
space - espacio
star - estrella
telescope - telescopio
The Earth - La Tierra
The Milky Way - La Vía Láctea
The moon - La Luna
The sun - El Sol
UFO - Ovni
universe - El Universo
Uranus - Urano
Venus - Venus
west - oeste