Vocabulario en inglés sobre sentimientos y emociones
adoration - adoración
affection - afecto
agitation - agitación
agony - agonía
alarm - alarma
amazement - asombro
amusement - divesión
anger - cólera, ira
anguish - angustia
annoyance - molestia
anxiety - ansiedad
apprehension - aprehensión
arousal - excitatión
astonishment - asombro
attraction - atracción
bitterness - amargura
bliss - felicidad
caring - preocupación
cheerfulness - alegría
compassion - compasión
contempt - desprecio
contentment - alegría
defeat - fracaso
dejection - desánimo
delight - placer
depression - depresión
desire - deseo
despair - desesperación
disappointment - desilusión
disgust - repugnancia
dislike - aversión
dismay - consternación
distress - angustia
dread - temor
eagerness - afán
ecstasy - éxtasis
elation - euforía
embarrassment - vergüenza, bochorno
enjoyment - placer
enthusiasm - entusiasmo
envy - envidia
euphoria - euforia
exasperation - exasperación
excitement - entusiasmo
exhilaration - regocijo
fear - miedo
ferocity - ferocidad
fondness - cariño
fright - susto
frustration - frustración
fury - furia
gaiety - alegría
glee - regocijo
gloom - tristeza
greed - avaricia
grief - pena
guilt - culpa
happiness - felicidad
hate - odio
homesickness - nostalgia
hope - esperanza
hopelessness - desesperación
horror - horror
hostility - hostilidad
humiliation - humillación
hurt - daño
hysteria - histeria
infatuation - encaprichamiento
insecurity - inseguridad
insult - insulto
irritation - irritación
isolation - aislamiento
jealousy - celos
joy - alegría
jubilation - júbilo
liking - gusto
loathing - odio, aversion
loneliness - soledad
longing - anhelo
love - amor
lust - lujuria
melancholy - melancolía
misery - aflicción, sufrimiento
mortification - mortificación
nervousness - nerviosismo
optimism - optimismo
outrage - indignación
pain - dolor
panic - pánico
passion - pasión
pity - compasión, lástima
pleasure - placer
pride - orgullo
rage - rabia
rapture - éxtasis
regret - remordimiento, lamento
rejection - rechazo
relief - alivio
remorse - remordimiento
repentance - arrepentimiento
resentment - resentimiento
revulsion - asco, repulsión
sadness - tristeza
satisfaction - satisfacción
scorn - desprecio
shame - vergüenza
shock - conmoción
sorrow - pena
spite - rencor, despecho
suffering - sufrimiento
surprise - sorpresa
sympathy - compasión
tenderness - ternura
tenseness - tensión
terror - terror
thrill - emoción
torment - tormento
triumph - triunfo
uneasiness - inquietud
unhappiness - infelicidad
woe - aflicción
worry - preocupación
wrath - ira
zeal - celo
zest - entusiasmo