Vocabulario en inglés sobre el dormitorio
air conditioner - aire acondicionado
alarm clock - reloj despertador
bed - cama
bedding - ropa de cama
bedspread - colcha, cubrecama
blanket - cobija, frazada
blinds - persianas
bunk bed - litera, cucheta
chest of drawers - cómoda
closet - placárd
comforter - cobertor acolchado
curtain - cortina
double bed - cama matrimonial
dresser - tocador
footboard - pie de la cama
hanger - percha
headboard - cabecera de la cama
lamp - lámpara
mattres - colchón
mirror - espejo
night table - mesita de noche
phone - teléfono
pillow - almohada
pillowcase - funda de almohada
plug - enchufe
rug - alfombra
sheets - sábanas
single bed - cama individual
socket - tomacorriente
switch - interruptor de luz
trunk - baúl
wardrobe - armario, ropero
Visita nuestro canal de videos en
YouTube