Vocabulario en inglés sobre carnes y aves
bacon - panceta, tocino
beef - carne vacuna
beef steak - bistec
black pudding - morcilla
blood sausage - morcilla
boneless - deshuesado
brains - sesos
breast - pechuga
cheeseburger - hamburguesa de queso
chicken - pollo
chop - chuleta
cold meats - fiambres
cooked - cocida
cutlet - chuleta
fowl - ave de corral
game - animales de caza
goat - cabrito
gravy - jugo (de carne)
grilled - a la parrilla
ground meat - carne picada
ham - jamón
hamburger - hamburguesa
kidneys - riñones
lamb - cordero
liver - hígado
marrow - médula
meatballs - albóndigas
medium rare - medio hecho
mutton - carne de oveja
pork - carne de cerdo
pork chops - chuletas de cerdo
pork loin - lomo de cerdo
pork sausage - chorizo
poultry - carne de ave
rare - poco cocida
ribs - costillas
roast beef - carne asada
roasted - asada
salami - salame
sausage - salchicha, chorizo
sirloin steak - bife de lomo
steak - bistéc
suckling pig - lechón
tongue - lengua
tripe - tripas
turkey - pavo
veal - carne de ternera
veal steak - bistéc ternera
venison - carne de venado
well done - bien cocida