Vocabulario en inglés sobre las aves
blackbird - mirlo
canary - canario
cardinal - cardenal
chick - pollito
chicken - pollo
cock - gallo
cockatoo - cacatúa
condor - cóndor
crane - grulla
crow - cuervo
duck - pato
eagle - águila
falcon - halcón
feather - pluma
flamingo - flamenco
goldfinch - jilguero
goose - ganso
hawk - halcón
hen - gallina
heron - garza
hummingbird - colibrí
kingfisher - martín pescador
lark - alondra
magpie - hurraca
nest - nido
nightingale - ruiseñor
ostrich - avestruz
owl - búho, lechuza
parakeet - periquito
parrot - loro, cotorra
partridge - perdiz
peacock - pavo real
pelican - pelícano
penguin - pinguino
pheasan - faisán
pigeon - paloma
quail - codorniz
roadrunner - correcaminos
robin - petirrojo
rooster - gallo
sea gull - gaviota
sparrow - gorrión
stork - cigueña
swallow - golondrina
swan - cisne
thrush - tordo
turkey - pavo
vulture - buitre
woodpecker - pájaro carpintero
Visita nuestro canal de videos en
YouTube