Vocabulario en inglés sobre nacionalidades
Afghan - Afgano
American - Americano
Argentinian - Argentino
Australian - Australiano
Austrian - Austríaco
Belgian - Belga
Bolivian - Boliviano
Brazilian - Brasileño
British - Británico
Bulgarian - Búlgaro
Canadian - Canadiense
Chilean - Chileno
Chinese - Chino
Colombian - Colombiano
Costa Rican - Costarricense
Cuban - Cubano
Czech - Checo
Danish - Danés
Dominican - Dominicano
Dutch - Holandés
Ecuadorean - Ecuadorean
Egyptian - Egipcio
English - inglés
Filipino - Filipino
Finnish - Finlandés
French - Francés
German - Alemán
Greek - Griego
Greenlander - Groenlandés
Guatemalan - Guatemalteco
Haitian - Haitiano
Hawaiian - Hawaiano
Honduran - Hondureño
Hungarian - Húngaro
Icelandic - Islandés
Indian - Indio
Indonesian - Indonesio
Iranian - Iraní
Iraqui - Iraqui
Irish - Irlandés
Israeli - Israelí
Italian - Italiano
Jamaican - Jamaicano
Japanese - Japonés
korean - coreano
Lebanese - Libanés
Malaysian - Malasio
Maltese - Maltés
Mexican - Mejicano
Moroccan - Marroquí
Nepalese - Nepalés
New Zealander - Neozelandés
Nicaraguan - Nicaragüense
Nigerian - Nigeriano
Norwegian - Noruego
Pakistani - Paquistaní
Palestinian - Palestino
Panamanian - Panameño
Paraguayan - Paraguayo
Peruvian - Peruano
Polish - Polaco
Portuguese - Portugués
Puerto Rican - Puertorriqueño
Rumanian - Rumano
Russian - Ruso
Saudi Arabian - Saudita
Scottish - Escocés
Singaporean - Singaporean
Spanish - Español
Swedish - Sueco
Swiss - Suizo
Syrian - Sirio
Tahitian - Tahitiano
Thai - Tailandés
Tunisian - Tunecino
Turkish - Turco
Ukrainian - Ucraniano
Uruguayan - Uruguayo
Venezuelan - Venezolano
Vietnamese - Vietnamita
Welsh - Galés
Yugoslavian - Yugoslavo