Vocabulario en inglés sobre el baño
basket - canasto
bath mat - alfombra de baño
bath salts - sales de baño
bathtub - bañera, tina
bidet - bidé
brush - cepillo
bubble - burbuja
cold water - agua fría
comb - peine
curtain - cortina
deodorant - desodorante
drain - desague
electric razor - afeitadora eléctrica
faucet - canilla, grifo
floss - hilo dental
foam - espuma
hair dryer - secador de pelo
hair gel - gomina, gel
hairbrush - cepillo de pelo
hand towel - toallita de mano
hot water - agua caliente
lipstick - lápiz de labios
lotion - loción
medicine chest - botiquín
nail clippers - cortaúñas
nail polish - esmalte de uñas
nailbrush - cepillo de uñas
perfume - perfume
razor - afeitadora, rasuradora
razor blade - hoja de afeitar
scale - balanza, báscula
shampoo - champú
shaving cream - crema de afeitar
shelf - repisa
shower - ducha
sink - pileta, lavabo
soap - jabón
soap dish - jabonera
sponge - esponja
stopper - tapón
tile - azulejo
toilet - inodoro, retrete
toilet paper - papel higiénico
toothbrush - cepillo de dientes
toothpaste - pasta dentífrica
towel - toalla
towel rack - toallero
tweezers - pinzas depiladoras
washcloth - toallita de ducha
Visita nuestro canal de videos en
YouTube