Vocabulario en inglés sobre el campamento y la pesca
backpack - mochila
bait - cebo, carnada
barbecue - parrilla
basket - canasto
binoculars - prismáticos
blanket - manta
camp fire - fogata
camp stove - cocina de campaña
camper - campista
campsite - sitio de camping
canoe - canoa, piragua
caravan - remolque
cascade - cascada
compass - brújula
cooler - nevera, hielera
facilities - instalaciones
firewood - leña
first-aid kit - botiquín de medicinas
fishing line - línea de pesca
fishing net - red de pesca
fishing rod - caña de pescar
flashlight - linterna
forest - bosque, selva
forest ranger - guardabosques
hiking boots - botas de excursionismo
hill - colina, sierra
hook - anzuelo, gancho
insect repellent - repelente para insectos
lake - lago
lantern - farol
logs - leños, troncos
map - mapa
matches - fósforos
mountain - montaña
penknife - navaja, cortaplumas
raft - balsa
raincoat - impermeable
rapids - rápidos
rifle - rifle
rope - soga, cuerda
shotgun - escopeta
sleeping bag - bolsa de dormir
stream - arroyo
tent - carpa, tienda de lona
thermos - termo
toilet paper - papel higiénico
toilets - retretes, aseos
trail - senda, sendero
trailer - remolque
trap - tampa
valley - valle
water bottle - cantimplora
waterfall - catarata
wilderness - tierra salvaje
wildlife - flora y fauna
wood - bosque
Visita nuestro canal de videos en
YouTube