Vocabulario en inglés sobre las frutas
almonds - almendras
apple - manzana
apricot - damasco, albaricoque
avocado - palta, aguacate
banana - banana
blackberry - zarzamora
cherry - cereza
chestnuts - castañas
coconuts - cocos
date - dátil
fig - higo
grapefruit - pomelo, toronja
grapes - uvas
hazelnuts - avellanas
lemon - limón
lime - lima
mango - mango
medlar - níspero
melon - melón
mulberry - mora
orange - naranja
peach - durazno, melocotón
peanuts - maníes
pear - pera
pineapple - ananá, piña
plum - ciruela
pomegranate - granada
quince - membrillo
raspberry - frambuesa
seed - semilla
strawberry - frutilla, fresa
tangerine - mandarina
walnuts - nueces
watermelon - sandía
Visita nuestro canal de videos en
YouTube