Vocabulario en inglés sobre deporte y actividades deportivas
aerobics - ejercicios aeróbicos
archery - arquería
athletics - atletismo
badminton - bádminton
baseball - béisbol
basketball - básquet
bicycling - ciclismo
billiards - billar
bowling - bolos
boxing - boxeo
canoeing - canotaje
car racing - automovilismo
diving - buceo
fencing - esgrima
fishing - pesca
football - fútbol americano
golf - golf
gymnastics - gimnasia
hang gliding - aladeltismo
hockey - hockey
horse racing - carrera de caballos
horse riding - equitación
hunting - caza
ice hockey - hockey sobre hielo
ice skating - patinaje sobre hielo
jogging - footing
karate - karate
martial arts - artes marciales
motorboat racing - carrera de lanchas
mountaineering - montañismo
parachuting - paracaidismo
ping-pong - tenis de mesa
polo - polo
pool - pool, billar americano
rowing - remo
sailing - navegación a vela
skating - patinaje
skiing - esquí
skydiving - paracaidismo acrobático
soccer - fútbol
surfing - surf
swimming - natación
target shooting - tiro al blanco
tennis - tenis
volleyball - vóleibol
water skiing - esquí acuático
weight lifting - pesas
windsurfing - windsurf
wrestling - lucha libre
Visita nuestro canal de videos en
YouTube¿Te sirvió esta información?
¡Compártela!
Mi curso Sherton
Síguenos en
Sherton English - curso de inglés gratis
Tweets
por @shertonenglish
Secciones principales
Inicio
Curso Sherton, Inglés en 52 semanas
Pizarrón del día
Foro
VOCABULARY.
ONE
Herramientas
Contacto
Testimonios
Términos de uso del sitio
Política de privacidad
Mapa del sitio
©1999-2020
Sherton English
Todos los derechos reservados.
Los contenidos de este sitio son originales y no pueden ser reproducidos sin la expresa autorización de los autores. En casos puntuales en los que la información provenga de otra fuente, ésta será expresamente citada.