Vocabulario en inglés sobre materiales y telas
acrylic - acrílico
aluminium - aluminio
brass - latón
bronze - bronce
canvas - lona
cardboard - cartón
cashmere - cachemira
cement - cemento
clay - arcilla
concrete - hormigón
copper - cobre
corduroy - corderoy
cotton - algodón
denim - tela de jean
feather - pluma
fiberglass - fibra de vidrio
flannel - franela
gauze - gasa
glass - vidrio
gold - oro
iron - hierro
lace - encaje
lead - plomo
leather - cuero
leather - cuero
linen - lino
marble - mármol
nylon - nylon
paper - papel
plaster - yeso
plastic - plástico
plywood - aglomerado
polyester - poliéster
porcelain - porcelana
pottery - cerámica
rayon - rayón
rubber - goma
silk - seda
silver - plata
steel - acero
stone - piedra
straw - paja
suede - gamuza
tin - estaño, hojalata
velvet - terciopelo
wax - cera
wood - madera
wool - lana
zinc - cinc