Vocabulario en inglés sobre plantas y árboles
apple tree - manzano
ash tree - fresno
bark - corteza
beech tree - haya
birch - abedul
branch - rama
branches - ramas
bush - arbusto
cactus - cactus
cedar - cedro
clover - trébol
coconut tree - cocotero
creeper - enredadera
cypress - ciprés
elm - olmo
fir tree - abeto
foliage - foliage
ivy - hiedra
leaf - hoja
leaves - hojas
lemon tree - limonero
mahogany - caoba
maple - arce
oak - roble
olive tree - olivo
orange tree - naranjo
palm tree - palmera
pine - pino
plane tree - plátano
poplar - álamo
roots - raíces
shrub - arbusto
trunk - tronco
twig - ramita
vine - vid, parra
vineyard - viñedo
walnut tree - nogal
weeds - malezas
weeping willow - sauce llorón
willow - sauce
Visita nuestro canal de videos en
YouTube