Inicio
Pizarrón del día
Noticias
Clases
eBook
Ingresar
¡Regístrate gratis!
¡Regístrate!
Siguiente »bakery - panadería
barber's - barbería
bookstore - librería
butcher's - carnicería
cake shop - pastelería
candy store - tienda de golosinas
children's wear - ropa de niño
clothing store - tienda de ropas
coffee shop - cafetería
confectioner's - pastelería
dairy store - lechería
delicatessen - fiambrería
drugstore - farmacia
dry cleaner's - tintorería
estate agency - agencia inmobiliaria
fishmonger's - pescadería
florist's - floristería
fruit shop - frutería
furniture store - mueblería
gas station - gasolinería
greengrocer's - verdulería
grocery store - almacén
hairdresser's - peluquería
hardware shop - ferretería
herbalist's shop - herboristería
ice-cream parlour - heladería
ironmonger's - ferretería
jeweller's - joyería
jewellery store - joyería
kiosk - quiosco
ladies' wear - ropa de señora
laundromat - lavandería automática
leather goods shop - marroquinería
mall - centro comercial
market - mercado
men's wear - ropa de caballero
music store - tienda de música
newsstand - quiosco de periódicos
optician's - optica
perfumery - perfumería
pet shop - tienda de animales
pharmacy - farmacia
shoe shop - zapatería
shopping center - centro comercial
shops - tiendas
souvenir shop - tienda de souvenirs
sports store - tienda de deportes
stationery store - papelería
stores - tiendas
supermarket - supermercado
toy store - juguetería
travel agency - agencia de viajes
vegetable store - verdulería
video store - tienda de videos
Visita nuestro canal de videos en
YouTube
