Vocabulario en inglés sobre la cocina
blender - licuadora
bottle opener - destapador de botellas
bowl - bol, taza grande
broom - escoba
cake mold - molde para repostería
can opener - abrelatas
canister - bote, lata
carving knife - cuchillo para trinchar
casserole - cazuelera
ceramic ware - vajilla de cerámica
cheese cutter - cortador de queso
chopping board - tabla para cortar
cleaver - cuchilla para picar
coffee maker - cafetera
colander - colador de verduras
corkscrew - destapador
counter - mesada
crokery - loza, vajilla
cup - taza
cupboard - alacena
cutlery - cubiertos
dish drainer - escurridor de platos
dish towel - repasador
dishwasher - lavaplatos
drawers - cajones
faucet - canilla, grifo
food processor - procesadora de alimentos
forks - tenedores
freezer - congelador
fridge - heladera
frying pan - sartén
funnel - embudo
garbage - basura
gloves - guantes
grater - rallador
ice tray - cubetera
juicer - juguera
kettle - pava
kitchen apron - delantal de cocina
knives - cuchillos
ladle - cucharón
lighter - encendedor
masher - pisapuré
microwave oven - horno microondas
mincer - picador, picadora
mixer - batidora
oven - horno
oven burner - quemador del horno
oven mitts - guantes para horno
pans - ollas, caserolas y sartenes
pepper mill - molinillo de pimienta
pot - olla
pot holder - agarradera
potato peeler - pelapapas
pressure cooker - olla a presión
recipe - receta
refrigerator - heladera
roasting pan - asadera
rolling pin - palo de amasar
salt shaker - salero
saucepan - cacerola
scouring pad - esponja limpiadora
sharpener - afilador de cuchillos
shelves - anaqueles, estantes
sieve - tamiz
sink - pileta de lavar
soap - jabón
spatula - espátula
spoons - cucharas
squeezer - exprimidor
steamer - vaporera
stove - cocina (aparato)
stove burners - quemadores de cocina
strainer - colador chico
teapot - tetera
teaspoons - cucharitas
toaster - tostadora
trash can - tacho de la basura
washing-up liquid - detergente
water heater - calefón
whisk - batidor de alambre
wok - sartén china
Visita nuestro canal de videos en
YouTube