Las partes de la ciudad en inglés
airport - aeropuerto
art gallery - galería de arte
arts center - centro cultural
avenue - avenida
bank - banco
bar - bar
bicycle - bicicleta
boarding house - pensión, casa de huéspedes
bookstall - kiosco, puesto de libros
botanical garden - jardín botánico
boulevard - bulevar
bridge - puente
building site - obra en construcción
buildings - edificios
bus - autobús
bus station - estación de autobuses
bus stop - parada de autobús
castle - castillo
cathedral - catedral
cemetery - cementerio
church - iglesia
circus - circo
city hall - ayuntamiento, municipalidad
clock - reloj
consulate - consulado
corner - esquina
crossroads - cruce
crosswalk - paso de peatones
cul-de-sac - callejón sin salida
curb - bordillo de la acera
department store - grandes almacenes
district - barrio, distrito
ditch - zanja
downtown - centro de la ciudad
drugstore - farmacia
embassy - embajada
fire brigade - cuerpo de bomberos
fountain - fuente
gutter - alcantarilla, cuneta
hairdresser's - peluquería
highway - autopista
hospital - hospital
hostel - hostal
hotel - hotel
house - casa
information office - oficina de información
inhabitant - habitante
lane - callejón
laundromat - lavadero automático
lawcourt - tribunal
library - biblioteca
litter - basura
mail box - buzón de correos
market - mercado
monument - monumento
mosque - mezquita
motorcycle - motocicleta
motorists - automovilistas
movie theater - cine
museum - museo
neighborhood - barrio, distrito
neon signs - letreros luminosos
newspaper stand - quiosco de periódicos
night club - club nocturno
old people's home - asilo de ancianos
orphanage - orfanato
outskirts - afueras de la ciudad
palace - palacio
park - parque
parking lot - aparcamiento
passage - pasaje
passer-by - transeúnte
pedestrian - peatón
pedestrian zone - zona peatonal
phone booth - cabina telefónica
police station - comisaría
port - puerto
post office - oficina de correos
prison - cárcel
promenade - paseo
railroad station - estación de ferrocarril
restaurant - restaurante
ring road - carretera de circunvalación
road - camino, carretera
school - escuela, colegio
sewers - cloacas
shop - tienda
shop windows - escaparates
shopping mall - centro comercial
sidewalk - acera
skyscraper - rascacielos
slums - barrio bajo
square - plaza
stadium - estadio
statue - estatua
stock exchange - la bolsa de valores
street - calle
streetcar - tranvía
streetlamps - faroles de calle
suburbs - las afueras de la ciudad
subway - metro, tren subterráneo
subway station - estación de metro
synagogue - sinagoga
taxi cab - taxi
telephones - teléfonos
theatre - teatro
tourist - turista
tourist office - oficina de turismo
townspeople - habitantes de la ciudad
traffic - tráfico, circulación
traffic light - semáforo
traffic policeman - policía de tránsito
tramp - vagabundo, mendigo
trashcan - papelera
travel agency - agencia de viajes
trees - árboles
truck - camión
tunnel - túnel
university - universidad
zoo - zoológico
Visita nuestro canal de videos en
YouTube